#########################
#----------------------##
###--------#####-----####
#######----#######--#####
######----------------###
####-----------####-----F
##---------##########---F
I----###------####------F
#------##-----###-------F
##---------######-------F
#######-----#####---#####
##---##-------##---######
#####---------------#####
#----------------------##
#########################
