##III###############
##    ##############
##      ############
#   #      #########
#  ####         ####
#  ######         ##
#  ######  #     ###
#  ####        #####
#  #          ######
#        #    ######
###     ###   ######
####     #    ######                        
####          ######
#####        #######  
#######FFF##########  
