###I################
##----##############
###-----############
#####------#########
#######---------####
##########--------##
##########--##---###
#######--------#####
####--------########
#------###-.########
##----#####---######
###----###---#######                        
####--------########
#####-----##########  
#######F############  