#######---------------#############
####--------#FFFF#-------##########
###-------#########-------#########
##-------##########---------#######
#------#############--------#######
#------#############---------######
#------##############----------####
#-------##############---------####
#-------##############---------####
#--------#############---------####
#--------#############---------####
#---------############---------####
#---------###########----------####
#----------##########----------####
#------------########----------####
##-----#------#######----------####
##----###------#####-----------####
##----###-------####--###------####
##----####-------###-####------####
##----####--------------------#####
##-----###-----------#######--#####
##-------------------######--######
###----------##-----######----#####
####---------##-----#######----####
#####--------###----#########---###
######------####---##########---###
########-----###---#########----###
###########-----------###------####
#############---------------#######
###############--IIII---###########
