-------------######FFFFFF
-------------######------
--------------######-----
-------####----######----
-------####----########--
--#-----####---########--
--##-----##----#######---
--###--------------------
--####---------#-----#---
--######-------######----
--######-------#####-----
---######-------###------
---#######------##-------
---#######------###------
---######-------###------
----#####--------##------
----######---------------
----#######--------------
----##########-----------
IIII###########----------
